111111111111
10PC0000C001
100100101111
110000000001
110E01100111
110001100111
11CC0000E111
111111111111
