111111111111
10PC0000C001
100100101111
110000000001
111100011111
110E01100111
110001100111
11CC00001111
111111111111