11111111111111111111111111111111111111111111111111111111111111111111111111
10C0000C000C0000C000C0000C000C0000C000C0000C000C0000C000C0000C000C0000C001
10C0000C000C0000C000C0000C000C0000C000C0000C000C0000C000C0000C000C0000C001
10C0000C000C0000C000C0000C000C0000C000C0000C000C0000C000C0000C000C0000C001
10C0000C000C0000C000C0000C000C0000C000C0000C000C0000C000C0000C000C0000C001
10C0000C000C0000C000C0000C000C0000C000C0000C000C0000C000C0000C000C0000C001
10C0000C000C00P0C000C0000C000C0000C000C0E00C000C0000C000C0000C000C0000C001
10C0000C000C0000C000C0000C000C0000C000C0000C000C0000C000C0000C000C0000C001
10C0000C000C0000C000C0000C000C0000C000C0000C000C0000C000C0000C000C0000C001
10C0000C000C0000C000C0000C000C0000C000C0000C000C0000C000C0000C000C0000C001
10C0000C000C0000C000C0000C000C0000C000C0000C000C0000C000C0000C000C0000C001
10C0000C000C0000C000C0000C000C0000C000C0000C000C0000C000C0000C000C0000C001
10C0000C000C0000C000C0000C000C0000C000C0000C000C0000C000C0000C000C0000C001
10C0000C000C0000C000C0000C000C0000C000C0000C000C0000C000C0000C000C0000C001
10C0000C000C0000C000C0000C000C0000C000C0000C000C0000C000C0000C000C0000C001
10C0000C000C0000C000C0000C000C0000C000C0000C000C0000C000C0000C000C0000C001
10C0000C000C0000C000C0000C000C0000C000C0000C000C0000C000C0000C000C0000C001
10C0000C000C0000C000C0000C000C0000C000C0000C000C0000C000C0000C000C0000C001
10C0000C000C0000C000C0000C000C0000C000C0000C000C0000C000C0000C000C0000C001
10C0000C000C0000C000C0000C000C0000C000C0000C000C0000C000C0000C000C0000C001
10C0000C000C0000C000C0000C000C0000C000C0000C000C0000C000C0000C000C0000C001
11111111111111111111111111111111111111111111111111111111111111111111111111