111111111111
10PC0000C001
100100101111
110000000001
111C01100111
111111100111
11CC0000E111
111111111111
